R 6000 6000

NO ./textures/bluestone.xpm
SO ./textures/greystone.xpm
WE ./textures/redbrick.xpm
EA ./textures/eagle.xpm

S ./textures/sunax.xpm
F 255,10,0
C 0,10,0


      111111111111111111111111
      100000000000000000000001
      10010000000000001000001
11111110000000000000000011111111
1000000000000000000000110000001111
100000001000000000000000000000000011
10000000000000000000000111000000001
1000000000000001000000011111111111
100000000000000000000001
1000000000000000000000011111111
1000000000002000000000000000001
1111100000002000000000011111001
    100000000000200000000011111
1111100000002000000000011111001
1000001000002000000000000000001
100001100000000000000011111111
100000100000000000000001
11111000000000N0000000011111
    100000000000000000000011
1111100000000000000001111111
100111000111111110000001
1001100011000001
10011000111111000001
11111111111111111111
