C   245 ,               54          ,     30
R       50000                                                                   50000
NO  ./textures/greystone.xpm
EA                                                                                                                      textures/wood.xpm
SO  ./textures/blue.xpm
WE  ./textures/red.xpm

S   ./textures/sprite.xpm
F           200 ,            200    ,                200

1111111111111111111111111111111111
100000E00000                  000000000      1 000000001111
100000000000000000  2   2       2000000000000000000000000000001


111111111111111111111111111111111111111111111111111111111111111



