R   1440 900

NO      ./textures/wood.xpm
SO ./textures/blue.xpm
EA ./textures/red.xpm
WE ./textures/brick.xpm

S ./textures/tonneau.xpm


C     23,44,134

        F         200,100,132



11111111111111
100000000001111111111111
1000000020002000E00000001
100000000002000111110211
100000200000000111110011
100000000000000111110011
11111100000002000000001
100000 00011100000000111
100020000000000000000001
1 00000000111001111111111
10000020011100000000001
10000000000000000000111111
100020010010101010100000000000000001
1000000000000000000001
100000200020000000000001
111111111111000000011111
         111000000011111
         111000000011111
         1111111111111
